Fungi_MK_Microcosms_Metsulfuron_methyl_001	TTATTACCGGATCCTCCGCTTATTGATATGC
Fungi_MK_Microcosms_Metsulfuron_methyl_002	TTATTAGGCGATCCTCCGCTTATTGATATGC
Fungi_MK_Microcosms_Metsulfuron_methyl_003	TTATTCTCCGATCCTCCGCTTATTGATATGC
Fungi_MK_Microcosms_Metsulfuron_methyl_004	TTATTCGTGGATCCTCCGCTTATTGATATGC
Fungi_MK_Microcosms_Metsulfuron_methyl_005	TTATTGCGAGATCCTCCGCTTATTGATATGC
Fungi_MK_Microcosms_Metsulfuron_methyl_006	TTATACTGGGATCCTCCGCTTATTGATATGC
Fungi_MK_Microcosms_Metsulfuron_methyl_007	TTATACCTCGATCCTCCGCTTATTGATATGC
Fungi_MK_Microcosms_Metsulfuron_methyl_008	TTATACGCAGATCCTCCGCTTATTGATATGC
Fungi_MK_Microcosms_Metsulfuron_methyl_009	TTATAGACCGATCCTCCGCTTATTGATATGC
Fungi_MK_Microcosms_Metsulfuron_methyl_010	TTATGTTCGGATCCTCCGCTTATTGATATGC
Fungi_MK_Microcosms_Metsulfuron_methyl_011	TTATGTGACGATCCTCCGCTTATTGATATGC
Fungi_MK_Microcosms_Metsulfuron_methyl_012	TTATGAAGGGATCCTCCGCTTATTGATATGC
Fungi_MK_Microcosms_Metsulfuron_methyl_013	TTATGAGCTGATCCTCCGCTTATTGATATGC
Fungi_MK_Microcosms_Metsulfuron_methyl_014	TTATGCCATGATCCTCCGCTTATTGATATGC
Fungi_MK_Microcosms_Metsulfuron_methyl_015	TTATGGTGTGATCCTCCGCTTATTGATATGC
Fungi_MK_Microcosms_Metsulfuron_methyl_016	TTAATTCGCGATCCTCCGCTTATTGATATGC
Fungi_MK_Microcosms_Metsulfuron_methyl_017	TTAATCCAGGATCCTCCGCTTATTGATATGC
Fungi_MK_Microcosms_Metsulfuron_methyl_018	TTAATCGGTGATCCTCCGCTTATTGATATGC
Fungi_MK_Microcosms_Metsulfuron_methyl_019	TTAATGTGGGATCCTCCGCTTATTGATATGC
Fungi_MK_Microcosms_Metsulfuron_methyl_020	TTAATGCCTGATCCTCCGCTTATTGATATGC
Fungi_MK_Microcosms_Metsulfuron_methyl_021	TTAATGGACGATCCTCCGCTTATTGATATGC
Fungi_MK_Microcosms_Metsulfuron_methyl_022	TTAACTTCCGATCCTCCGCTTATTGATATGC
Fungi_MK_Microcosms_Metsulfuron_methyl_023	TTAACTAGGGATCCTCCGCTTATTGATATGC
Fungi_MK_Microcosms_Metsulfuron_methyl_024	TTAACAGTCGATCCTCCGCTTATTGATATGC
Fungi_MK_Microcosms_Metsulfuron_methyl_025	TTAACCTTGGATCCTCCGCTTATTGATATGC
Fungi_MK_Microcosms_Metsulfuron_methyl_026	TTAACCGAAGATCCTCCGCTTATTGATATGC
Fungi_MK_Microcosms_Metsulfuron_methyl_027	TTAACGACAGATCCTCCGCTTATTGATATGC
Fungi_MK_Microcosms_Metsulfuron_methyl_028	TTACTTACGGATCCTCCGCTTATTGATATGC
Fungi_MK_Microcosms_Metsulfuron_methyl_029	TTACTTGTCGATCCTCCGCTTATTGATATGC
Fungi_MK_Microcosms_Metsulfuron_methyl_030	TTACTAGAGGATCCTCCGCTTATTGATATGC
Fungi_MK_Microcosms_Metsulfuron_methyl_031	TTACTCTGAGATCCTCCGCTTATTGATATGC
Fungi_MK_Microcosms_Metsulfuron_methyl_032	TTACTCCTTGATCCTCCGCTTATTGATATGC
Fungi_MK_Microcosms_Metsulfuron_methyl_033	TTACTGGCAGATCCTCCGCTTATTGATATGC
Fungi_MK_Microcosms_Metsulfuron_methyl_034	TTACATTGCGATCCTCCGCTTATTGATATGC
Fungi_MK_Microcosms_Metsulfuron_methyl_035	TTACAGTAGGATCCTCCGCTTATTGATATGC
Fungi_MK_Microcosms_Metsulfuron_methyl_036	TTACAGGTTGATCCTCCGCTTATTGATATGC
Fungi_MK_Microcosms_Metsulfuron_methyl_037	TTACCTAACGATCCTCCGCTTATTGATATGC
Fungi_MK_Microcosms_Metsulfuron_methyl_038	TTACCTCTAGATCCTCCGCTTATTGATATGC
Fungi_MK_Microcosms_Metsulfuron_methyl_039	TTACCTGGTGATCCTCCGCTTATTGATATGC
Fungi_MK_Microcosms_Metsulfuron_methyl_040	TTACCATCGGATCCTCCGCTTATTGATATGC
Fungi_MK_Microcosms_Metsulfuron_methyl_041	TTACCGTTCGATCCTCCGCTTATTGATATGC
Fungi_MK_Microcosms_Metsulfuron_methyl_042	TTACGTCAGGATCCTCCGCTTATTGATATGC
Fungi_MK_Microcosms_Metsulfuron_methyl_043	TTACGATACGATCCTCCGCTTATTGATATGC
Fungi_MK_Microcosms_Metsulfuron_methyl_044	TTACGACCAGATCCTCCGCTTATTGATATGC
Fungi_MK_Microcosms_Metsulfuron_methyl_045	TTACGCCGCGATCCTCCGCTTATTGATATGC
Fungi_MK_Microcosms_Metsulfuron_methyl_046	TTACGCGTAGATCCTCCGCTTATTGATATGC
Fungi_MK_Microcosms_Metsulfuron_methyl_047	TTAGTTCTGGATCCTCCGCTTATTGATATGC
Fungi_MK_Microcosms_Metsulfuron_methyl_048	TTAGTTGGAGATCCTCCGCTTATTGATATGC
Fungi_MK_Microcosms_Metsulfuron_methyl_049	TTAGTAACCGATCCTCCGCTTATTGATATGC
Fungi_MK_Microcosms_Metsulfuron_methyl_050	TTAGTACGTGATCCTCCGCTTATTGATATGC
Fungi_MK_Microcosms_Metsulfuron_methyl_051	TTAGATCCTGATCCTCCGCTTATTGATATGC
Fungi_MK_Microcosms_Metsulfuron_methyl_052	TTAGATGAGGATCCTCCGCTTATTGATATGC
Fungi_MK_Microcosms_Metsulfuron_methyl_053	TTAGACTACGATCCTCCGCTTATTGATATGC
Fungi_MK_Microcosms_Metsulfuron_methyl_054	TTAGACATGGATCCTCCGCTTATTGATATGC
Fungi_MK_Microcosms_Metsulfuron_methyl_055	TTAGAGTCAGATCCTCCGCTTATTGATATGC
Fungi_MK_Microcosms_Metsulfuron_methyl_056	TTAGCAGATGATCCTCCGCTTATTGATATGC
Fungi_MK_Microcosms_Metsulfuron_methyl_057	TTAGCCTGTGATCCTCCGCTTATTGATATGC
Fungi_MK_Microcosms_Metsulfuron_methyl_058	TTAGGTACAGATCCTCCGCTTATTGATATGC
Fungi_MK_Microcosms_Metsulfuron_methyl_059	TTAGGCGCCGATCCTCCGCTTATTGATATGC
Fungi_MK_Microcosms_Metsulfuron_methyl_060	TTCTTATGGGATCCTCCGCTTATTGATATGC
Fungi_MK_Microcosms_Metsulfuron_methyl_061	TTCTTACTCGATCCTCCGCTTATTGATATGC
Fungi_MK_Microcosms_Metsulfuron_methyl_062	TTCTTAGCAGATCCTCCGCTTATTGATATGC
Fungi_MK_Microcosms_Metsulfuron_methyl_063	TTCTTCAGTGATCCTCCGCTTATTGATATGC
Fungi_MK_Microcosms_Metsulfuron_methyl_064	TTCTTCGACGATCCTCCGCTTATTGATATGC
Fungi_MK_Microcosms_Metsulfuron_methyl_065	TTCTTGAAGGATCCTCCGCTTATTGATATGC
Fungi_MK_Microcosms_Metsulfuron_methyl_066	TTCTTGGTTGATCCTCCGCTTATTGATATGC
Fungi_MK_Microcosms_Metsulfuron_methyl_067	TTCTATTCCGATCCTCCGCTTATTGATATGC
Fungi_MK_Microcosms_Metsulfuron_methyl_068	TTCTATAGGGATCCTCCGCTTATTGATATGC
Fungi_MK_Microcosms_Metsulfuron_methyl_069	TTCTAACAGGATCCTCCGCTTATTGATATGC
Fungi_MK_Microcosms_Metsulfuron_methyl_070	TTCTACCGAGATCCTCCGCTTATTGATATGC
Fungi_MK_Microcosms_Metsulfuron_methyl_071	TTCTAGTTGGATCCTCCGCTTATTGATATGC
Fungi_MK_Microcosms_Metsulfuron_methyl_072	TTCTAGCCTGATCCTCCGCTTATTGATATGC
Fungi_MK_Microcosms_Metsulfuron_methyl_073	TTCTAGGAAGATCCTCCGCTTATTGATATGC
Fungi_MK_Microcosms_Metsulfuron_methyl_074	TTCTCTTAGGATCCTCCGCTTATTGATATGC
Fungi_MK_Microcosms_Metsulfuron_methyl_075	TTCTCTACAGATCCTCCGCTTATTGATATGC
Fungi_MK_Microcosms_Metsulfuron_methyl_076	TTCTCTCTTGATCCTCCGCTTATTGATATGC
Fungi_MK_Microcosms_Metsulfuron_methyl_077	TTCTCTGGCGATCCTCCGCTTATTGATATGC
Fungi_MK_Microcosms_Metsulfuron_methyl_078	TTCTCCATCGATCCTCCGCTTATTGATATGC
Fungi_MK_Microcosms_Metsulfuron_methyl_079	TTCTCCGCTGATCCTCCGCTTATTGATATGC
Fungi_MK_Microcosms_Metsulfuron_methyl_080	TTCTCGTGAGATCCTCCGCTTATTGATATGC
Fungi_MK_Microcosms_Metsulfuron_methyl_081	TTCTGTGTAGATCCTCCGCTTATTGATATGC
Fungi_MK_Microcosms_Metsulfuron_methyl_082	TTCTGAACCGATCCTCCGCTTATTGATATGC
Fungi_MK_Microcosms_Metsulfuron_methyl_083	TTCTGACGTGATCCTCCGCTTATTGATATGC
Fungi_MK_Microcosms_Metsulfuron_methyl_084	TTCTGCTCAGATCCTCCGCTTATTGATATGC
Fungi_MK_Microcosms_Metsulfuron_methyl_085	TTCATTGTGGATCCTCCGCTTATTGATATGC
Fungi_MK_Microcosms_Metsulfuron_methyl_086	TTCATCTTCGATCCTCCGCTTATTGATATGC
Fungi_MK_Microcosms_Metsulfuron_methyl_087	TTCATGTCAGATCCTCCGCTTATTGATATGC
Fungi_MK_Microcosms_Metsulfuron_methyl_088	TTCAGTTACGATCCTCCGCTTATTGATATGC
Fungi_MK_Microcosms_Metsulfuron_methyl_089	TTCAGTCCTGATCCTCCGCTTATTGATATGC
Fungi_MK_Microcosms_Metsulfuron_methyl_090	TTCAGATTGGATCCTCCGCTTATTGATATGC
Fungi_MK_Microcosms_Metsulfuron_methyl_091	TTCAGAAGAGATCCTCCGCTTATTGATATGC
Fungi_MK_Microcosms_Metsulfuron_methyl_092	TTCAGCTGTGATCCTCCGCTTATTGATATGC