AOA_MK_Microcosms_Metsulfuron_methyl_001	ATTACCGGGTGGATAC
AOA_MK_Microcosms_Metsulfuron_methyl_002	ATTAGGCGGTGGATAC
AOA_MK_Microcosms_Metsulfuron_methyl_003	ATACTCCGGTGGATAC
AOA_MK_Microcosms_Metsulfuron_methyl_004	ATACAGGGGTGGATAC
AOA_MK_Microcosms_Metsulfuron_methyl_005	ATAGCTGGGTGGATAC
AOA_MK_Microcosms_Metsulfuron_methyl_006	ATAGGACGGTGGATAC
AOA_MK_Microcosms_Metsulfuron_methyl_007	ATGTTGGGGTGGATAC
AOA_MK_Microcosms_Metsulfuron_methyl_008	ATGTCTCGGTGGATAC
AOA_MK_Microcosms_Metsulfuron_methyl_009	ATGAACCGGTGGATAC
AOA_MK_Microcosms_Metsulfuron_methyl_010	ATGACGTGGTGGATAC
AOA_MK_Microcosms_Metsulfuron_methyl_011	ATGAGAGGGTGGATAC
AOA_MK_Microcosms_Metsulfuron_methyl_012	ATGGTCAGGTGGATAC
AOA_MK_Microcosms_Metsulfuron_methyl_013	AATCTCGGGTGGATAC
AOA_MK_Microcosms_Metsulfuron_methyl_014	AATCAGCGGTGGATAC
AOA_MK_Microcosms_Metsulfuron_methyl_015	AATGGTGGGTGGATAC
AOA_MK_Microcosms_Metsulfuron_methyl_016	AACTACCGGTGGATAC
AOA_MK_Microcosms_Metsulfuron_methyl_017	AACTCTGGGTGGATAC
AOA_MK_Microcosms_Metsulfuron_methyl_018	AACTGGAGGTGGATAC
AOA_MK_Microcosms_Metsulfuron_methyl_019	AACAAGGGGTGGATAC
AOA_MK_Microcosms_Metsulfuron_methyl_020	AACACACGGTGGATAC
AOA_MK_Microcosms_Metsulfuron_methyl_021	AACCGTTGGTGGATAC
AOA_MK_Microcosms_Metsulfuron_methyl_022	AACGTAGGGTGGATAC
AOA_MK_Microcosms_Metsulfuron_methyl_023	AACGCCTGGTGGATAC
AOA_MK_Microcosms_Metsulfuron_methyl_024	AAGTCCAGGTGGATAC
AOA_MK_Microcosms_Metsulfuron_methyl_025	AAGTGACGGTGGATAC
AOA_MK_Microcosms_Metsulfuron_methyl_026	AAGAGCTGGTGGATAC
AOA_MK_Microcosms_Metsulfuron_methyl_027	AAGCATGGGTGGATAC
AOA_MK_Microcosms_Metsulfuron_methyl_028	AAGGAGTGGTGGATAC
AOA_MK_Microcosms_Metsulfuron_methyl_029	ACTTACGGGTGGATAC
AOA_MK_Microcosms_Metsulfuron_methyl_030	ACTTGTCGGTGGATAC
AOA_MK_Microcosms_Metsulfuron_methyl_031	ACTATGGGGTGGATAC
AOA_MK_Microcosms_Metsulfuron_methyl_032	ACTAGCAGGTGGATAC
AOA_MK_Microcosms_Metsulfuron_methyl_033	ACTCCTTGGTGGATAC
AOA_MK_Microcosms_Metsulfuron_methyl_034	ACTCGAGGGTGGATAC
AOA_MK_Microcosms_Metsulfuron_methyl_035	ACATCACGGTGGATAC
AOA_MK_Microcosms_Metsulfuron_methyl_036	ACAACCTGGTGGATAC
AOA_MK_Microcosms_Metsulfuron_methyl_037	ACAAGTGGGTGGATAC
AOA_MK_Microcosms_Metsulfuron_methyl_038	ACACTGTGGTGGATAC
AOA_MK_Microcosms_Metsulfuron_methyl_039	ACACATCGGTGGATAC
AOA_MK_Microcosms_Metsulfuron_methyl_040	ACAGTCGGGTGGATAC
AOA_MK_Microcosms_Metsulfuron_methyl_041	ACAGAGAGGTGGATAC
AOA_MK_Microcosms_Metsulfuron_methyl_042	ACCTAGTGGTGGATAC
AOA_MK_Microcosms_Metsulfuron_methyl_043	ACCACTAGGTGGATAC
AOA_MK_Microcosms_Metsulfuron_methyl_044	ACCAGATGGTGGATAC
AOA_MK_Microcosms_Metsulfuron_methyl_045	ACCGAACGGTGGATAC
AOA_MK_Microcosms_Metsulfuron_methyl_046	ACCGCGGGGTGGATAC
AOA_MK_Microcosms_Metsulfuron_methyl_047	ACGATACGGTGGATAC
AOA_MK_Microcosms_Metsulfuron_methyl_048	ACGCTTAGGTGGATAC
AOA_MK_Microcosms_Metsulfuron_methyl_049	ACGCAATGGTGGATAC
AOA_MK_Microcosms_Metsulfuron_methyl_050	ACGCCGCGGTGGATAC
AOA_MK_Microcosms_Metsulfuron_methyl_051	AGTACGAGGTGGATAC
AOA_MK_Microcosms_Metsulfuron_methyl_052	AGTCTACGGTGGATAC
AOA_MK_Microcosms_Metsulfuron_methyl_053	AGTCGCTGGTGGATAC
AOA_MK_Microcosms_Metsulfuron_methyl_054	AGTGTGTGGTGGATAC
AOA_MK_Microcosms_Metsulfuron_methyl_055	AGTGATCGGTGGATAC
AOA_MK_Microcosms_Metsulfuron_methyl_056	AGTGGAAGGTGGATAC
AOA_MK_Microcosms_Metsulfuron_methyl_057	AGATAGCGGTGGATAC
AOA_MK_Microcosms_Metsulfuron_methyl_058	AGAACTCGGTGGATAC
AOA_MK_Microcosms_Metsulfuron_methyl_059	AGAAGGTGGTGGATAC
AOA_MK_Microcosms_Metsulfuron_methyl_060	AGACTTGGGTGGATAC
AOA_MK_Microcosms_Metsulfuron_methyl_061	AGACCATGGTGGATAC
AOA_MK_Microcosms_Metsulfuron_methyl_062	AGAGAAGGGTGGATAC
AOA_MK_Microcosms_Metsulfuron_methyl_063	AGCTCAAGGTGGATAC
AOA_MK_Microcosms_Metsulfuron_methyl_064	AGCATCTGGTGGATAC
AOA_MK_Microcosms_Metsulfuron_methyl_065	AGCCTGAGGTGGATAC
AOA_MK_Microcosms_Metsulfuron_methyl_066	AGCCACGGGTGGATAC
AOA_MK_Microcosms_Metsulfuron_methyl_067	AGCGGCCGGTGGATAC
AOA_MK_Microcosms_Metsulfuron_methyl_068	AGGCGTCGGTGGATAC
AOA_MK_Microcosms_Metsulfuron_methyl_069	GTTAAGGGGTGGATAC
AOA_MK_Microcosms_Metsulfuron_methyl_070	GTTACTCGGTGGATAC
AOA_MK_Microcosms_Metsulfuron_methyl_071	GTTGTTGGGTGGATAC
AOA_MK_Microcosms_Metsulfuron_methyl_072	GTTGAACGGTGGATAC
AOA_MK_Microcosms_Metsulfuron_methyl_073	GTTGGCTGGTGGATAC
AOA_MK_Microcosms_Metsulfuron_methyl_074	GTAATCGGGTGGATAC
AOA_MK_Microcosms_Metsulfuron_methyl_075	GTACTGAGGTGGATAC
AOA_MK_Microcosms_Metsulfuron_methyl_076	GTACACTGGTGGATAC
AOA_MK_Microcosms_Metsulfuron_methyl_077	GTACCAGGGTGGATAC
AOA_MK_Microcosms_Metsulfuron_methyl_078	GTACGTCGGTGGATAC
AOA_MK_Microcosms_Metsulfuron_methyl_079	GTAGCGCGGTGGATAC
AOA_MK_Microcosms_Metsulfuron_methyl_080	GTCTTACGGTGGATAC
AOA_MK_Microcosms_Metsulfuron_methyl_081	GTCTATGGGTGGATAC
AOA_MK_Microcosms_Metsulfuron_methyl_082	GTCTCCTGGTGGATAC
AOA_MK_Microcosms_Metsulfuron_methyl_083	GTCAACAGGTGGATAC
AOA_MK_Microcosms_Metsulfuron_methyl_084	GTCAGTTGGTGGATAC
AOA_MK_Microcosms_Metsulfuron_methyl_085	GTCCGAAGGTGGATAC
AOA_MK_Microcosms_Metsulfuron_methyl_086	GTCGTGTGGTGGATAC
AOA_MK_Microcosms_Metsulfuron_methyl_087	GTGTAGTGGTGGATAC
AOA_MK_Microcosms_Metsulfuron_methyl_088	GTGTCAAGGTGGATAC
AOA_MK_Microcosms_Metsulfuron_methyl_089	GTGAGGAGGTGGATAC
AOA_MK_Microcosms_Metsulfuron_methyl_090	GTGGATAGGTGGATAC
AOA_MK_Microcosms_Metsulfuron_methyl_091	GTGGCCGGGTGGATAC
AOA_MK_Microcosms_Metsulfuron_methyl_092	GATAACCGGTGGATAC