Bacteria_MK_Microcosms_Metsulfuron_methyl_001	TTCTTCTTCGTGTG
Bacteria_MK_Microcosms_Metsulfuron_methyl_002	TTCTCAATGGTGTG
Bacteria_MK_Microcosms_Metsulfuron_methyl_003	TTCAGTTCAGTGTG
Bacteria_MK_Microcosms_Metsulfuron_methyl_004	TTCGAATCAGTGTG
Bacteria_MK_Microcosms_Metsulfuron_methyl_005	TTGTCAGGTGTGTG
Bacteria_MK_Microcosms_Metsulfuron_methyl_006	TTGAAGTTCGTGTG
Bacteria_MK_Microcosms_Metsulfuron_methyl_007	TTGCAACAAGTGTG
Bacteria_MK_Microcosms_Metsulfuron_methyl_008	TTGGACGACGTGTG
Bacteria_MK_Microcosms_Metsulfuron_methyl_009	TTCTTCAAGGTGTG
Bacteria_MK_Microcosms_Metsulfuron_methyl_010	TTCTCAGAAGTGTG
Bacteria_MK_Microcosms_Metsulfuron_methyl_011	TTCAGTAAGGTGTG
Bacteria_MK_Microcosms_Metsulfuron_methyl_012	TTCGACAATGTGTG
Bacteria_MK_Microcosms_Metsulfuron_methyl_013	TTGTCGATAGTGTG
Bacteria_MK_Microcosms_Metsulfuron_methyl_014	TTGAAGGAAGTGTG
Bacteria_MK_Microcosms_Metsulfuron_methyl_015	TTGCAGTATGTGTG
Bacteria_MK_Microcosms_Metsulfuron_methyl_016	TATATCAGGGTGTG
Bacteria_MK_Microcosms_Metsulfuron_methyl_017	TTCTTGTCAGTGTG
Bacteria_MK_Microcosms_Metsulfuron_methyl_018	TTCATATGGGTGTG
Bacteria_MK_Microcosms_Metsulfuron_methyl_019	TTCAGACTTGTGTG
Bacteria_MK_Microcosms_Metsulfuron_methyl_020	TTCGAGCACGTGTG
Bacteria_MK_Microcosms_Metsulfuron_methyl_021	TTGTGTATCGTGTG
Bacteria_MK_Microcosms_Metsulfuron_methyl_022	TTGACTATGGTGTG
Bacteria_MK_Microcosms_Metsulfuron_methyl_023	TTGCCTAGTGTGTG
Bacteria_MK_Microcosms_Metsulfuron_methyl_024	TATATCGTCGTGTG
Bacteria_MK_Microcosms_Metsulfuron_methyl_025	TTCTTGAGTGTGTG
Bacteria_MK_Microcosms_Metsulfuron_methyl_026	TTCATAGTCGTGTG
Bacteria_MK_Microcosms_Metsulfuron_methyl_027	TTCAGAGGAGTGTG
Bacteria_MK_Microcosms_Metsulfuron_methyl_028	TTGTTCAGAGTGTG
Bacteria_MK_Microcosms_Metsulfuron_methyl_029	TTGTGTGAAGTGTG
Bacteria_MK_Microcosms_Metsulfuron_methyl_030	TTGACGTGAGTGTG
Bacteria_MK_Microcosms_Metsulfuron_methyl_031	TTGCCTCACGTGTG
Bacteria_MK_Microcosms_Metsulfuron_methyl_032	TATATGCACGTGTG
Bacteria_MK_Microcosms_Metsulfuron_methyl_033	TTCTTGGACGTGTG
Bacteria_MK_Microcosms_Metsulfuron_methyl_034	TTCATCACAGTGTG
Bacteria_MK_Microcosms_Metsulfuron_methyl_035	TTCAGCAGTGTGTG
Bacteria_MK_Microcosms_Metsulfuron_methyl_036	TTGTTCGTTGTGTG
Bacteria_MK_Microcosms_Metsulfuron_methyl_037	TTGTGACTAGTGTG
Bacteria_MK_Microcosms_Metsulfuron_methyl_038	TTGACGAATGTGTG
Bacteria_MK_Microcosms_Metsulfuron_methyl_039	TTGCCAATCGTGTG
Bacteria_MK_Microcosms_Metsulfuron_methyl_040	TATAACGAGGTGTG
Bacteria_MK_Microcosms_Metsulfuron_methyl_041	TTCTATAGGGTGTG
Bacteria_MK_Microcosms_Metsulfuron_methyl_042	TTCATCGATGTGTG
Bacteria_MK_Microcosms_Metsulfuron_methyl_043	TTCAGCCAAGTGTG
Bacteria_MK_Microcosms_Metsulfuron_methyl_044	TTGTTGTAGGTGTG
Bacteria_MK_Microcosms_Metsulfuron_methyl_045	TTGTGCAATGTGTG
Bacteria_MK_Microcosms_Metsulfuron_methyl_046	TTGAGTTGGGTGTG
Bacteria_MK_Microcosms_Metsulfuron_methyl_047	TTGCCAGAGGTGTG
Bacteria_MK_Microcosms_Metsulfuron_methyl_048	TATAAGTGGGTGTG
Bacteria_MK_Microcosms_Metsulfuron_methyl_049	TTCTATCTCGTGTG
Bacteria_MK_Microcosms_Metsulfuron_methyl_050	TTCAATCGTGTGTG
Bacteria_MK_Microcosms_Metsulfuron_methyl_051	TTCAGGTATGTGTG
Bacteria_MK_Microcosms_Metsulfuron_methyl_052	TTGTATCGAGTGTG
Bacteria_MK_Microcosms_Metsulfuron_methyl_053	TTGTGGTGTGTGTG
Bacteria_MK_Microcosms_Metsulfuron_methyl_054	TTGAGTCATGTGTG
Bacteria_MK_Microcosms_Metsulfuron_methyl_055	TTGGTTGTCGTGTG
Bacteria_MK_Microcosms_Metsulfuron_methyl_056	TATAAGCCAGTGTG
Bacteria_MK_Microcosms_Metsulfuron_methyl_057	TTCTATGCAGTGTG
Bacteria_MK_Microcosms_Metsulfuron_methyl_058	TTCAATGACGTGTG
Bacteria_MK_Microcosms_Metsulfuron_methyl_059	TTCGTTCTAGTGTG
Bacteria_MK_Microcosms_Metsulfuron_methyl_060	TTGTAATGGGTGTG
Bacteria_MK_Microcosms_Metsulfuron_methyl_061	TTGATAGCAGTGTG
Bacteria_MK_Microcosms_Metsulfuron_methyl_062	TTGAGAGTGGTGTG
Bacteria_MK_Microcosms_Metsulfuron_methyl_063	TTGGTATGAGTGTG
Bacteria_MK_Microcosms_Metsulfuron_methyl_064	TATAGTCTCGTGTG
Bacteria_MK_Microcosms_Metsulfuron_methyl_065	TTCTAACAGGTGTG
Bacteria_MK_Microcosms_Metsulfuron_methyl_066	TTCAACTAGGTGTG
Bacteria_MK_Microcosms_Metsulfuron_methyl_067	TTCGTTGGTGTGTG
Bacteria_MK_Microcosms_Metsulfuron_methyl_068	TTGTAAGTCGTGTG
Bacteria_MK_Microcosms_Metsulfuron_methyl_069	TTGATCTTGGTGTG
Bacteria_MK_Microcosms_Metsulfuron_methyl_070	TTGAGCCTCGTGTG
Bacteria_MK_Microcosms_Metsulfuron_methyl_071	TTGGTCTATGTGTG
Bacteria_MK_Microcosms_Metsulfuron_methyl_072	TATAGACAGGTGTG
Bacteria_MK_Microcosms_Metsulfuron_methyl_073	TTCTAGTTGGTGTG
Bacteria_MK_Microcosms_Metsulfuron_methyl_074	TTCAACATCGTGTG
Bacteria_MK_Microcosms_Metsulfuron_methyl_075	TTCGTAGAGGTGTG
Bacteria_MK_Microcosms_Metsulfuron_methyl_076	TTGTAGAACGTGTG
Bacteria_MK_Microcosms_Metsulfuron_methyl_077	TTGATCAACGTGTG
Bacteria_MK_Microcosms_Metsulfuron_methyl_078	TTGAGGACAGTGTG
Bacteria_MK_Microcosms_Metsulfuron_methyl_079	TTGGTGCCAGTGTG
Bacteria_MK_Microcosms_Metsulfuron_methyl_080	TATAGAGGTGTGTG
Bacteria_MK_Microcosms_Metsulfuron_methyl_081	TTCTCTTGTGTGTG
Bacteria_MK_Microcosms_Metsulfuron_methyl_082	TTCAAGAGAGTGTG
Bacteria_MK_Microcosms_Metsulfuron_methyl_083	TTCGTGATCGTGTG
Bacteria_MK_Microcosms_Metsulfuron_methyl_084	TTGTCTTCAGTGTG
Bacteria_MK_Microcosms_Metsulfuron_methyl_085	TTGATGAGGGTGTG
Bacteria_MK_Microcosms_Metsulfuron_methyl_086	TTGCATAAGGTGTG
Bacteria_MK_Microcosms_Metsulfuron_methyl_087	TTGGAACTTGTGTG
Bacteria_MK_Microcosms_Metsulfuron_methyl_088	TATAGCAACGTGTG
Bacteria_MK_Microcosms_Metsulfuron_methyl_089	TTCTCTAACGTGTG
Bacteria_MK_Microcosms_Metsulfuron_methyl_090	TTCAAGGTTGTGTG
Bacteria_MK_Microcosms_Metsulfuron_methyl_091	TTCGATGTGGTGTG
Bacteria_MK_Microcosms_Metsulfuron_methyl_092	TTGTCTCTTGTGTG