AOB_MK_Microcosms_Metsulfuron_methyl_001	TATTACGCAAGGGGTTTCTACTGGTG
AOB_MK_Microcosms_Metsulfuron_methyl_002	TATTCGTCAAGGGGTTTCTACTGGTG
AOB_MK_Microcosms_Metsulfuron_methyl_003	TATATGGCAAGGGGTTTCTACTGGTG
AOB_MK_Microcosms_Metsulfuron_methyl_004	TATCTCTCAAGGGGTTTCTACTGGTG
AOB_MK_Microcosms_Metsulfuron_methyl_005	TATCCTACAAGGGGTTTCTACTGGTG
AOB_MK_Microcosms_Metsulfuron_methyl_006	TATCGAGCAAGGGGTTTCTACTGGTG
AOB_MK_Microcosms_Metsulfuron_methyl_007	TATGGTTCAAGGGGTTTCTACTGGTG
AOB_MK_Microcosms_Metsulfuron_methyl_008	TAATCTGCAAGGGGTTTCTACTGGTG
AOB_MK_Microcosms_Metsulfuron_methyl_009	TAATGCTCAAGGGGTTTCTACTGGTG
AOB_MK_Microcosms_Metsulfuron_methyl_010	TAAGCATCAAGGGGTTTCTACTGGTG
AOB_MK_Microcosms_Metsulfuron_methyl_011	TACTTGACAAGGGGTTTCTACTGGTG
AOB_MK_Microcosms_Metsulfuron_methyl_012	TACAATGCAAGGGGTTTCTACTGGTG
AOB_MK_Microcosms_Metsulfuron_methyl_013	TACGTCGCAAGGGGTTTCTACTGGTG
AOB_MK_Microcosms_Metsulfuron_methyl_015	TCTACTTCAAGGGGTTTCTACTGGTG
AOB_MK_Microcosms_Metsulfuron_methyl_016	TCTACGATAAGGGGTTTCTACTGGTG
AOB_MK_Microcosms_Metsulfuron_methyl_017	TCTCTTGCAAGGGGTTTCTACTGGTG
AOB_MK_Microcosms_Metsulfuron_methyl_018	TCTCTGTTAAGGGGTTTCTACTGGTG
AOB_MK_Microcosms_Metsulfuron_methyl_019	TCTCATCTAAGGGGTTTCTACTGGTG
AOB_MK_Microcosms_Metsulfuron_methyl_020	TCTCGCATAAGGGGTTTCTACTGGTG
AOB_MK_Microcosms_Metsulfuron_methyl_021	TCTGTGACAAGGGGTTTCTACTGGTG
AOB_MK_Microcosms_Metsulfuron_methyl_022	TCTGACTCAAGGGGTTTCTACTGGTG
AOB_MK_Microcosms_Metsulfuron_methyl_023	TCTGGATTAAGGGGTTTCTACTGGTG
AOB_MK_Microcosms_Metsulfuron_methyl_024	TCATTCGCAAGGGGTTTCTACTGGTG
AOB_MK_Microcosms_Metsulfuron_methyl_025	TCATCGTTAAGGGGTTTCTACTGGTG
AOB_MK_Microcosms_Metsulfuron_methyl_026	TCATGTCTAAGGGGTTTCTACTGGTG
AOB_MK_Microcosms_Metsulfuron_methyl_027	TCATGGACAAGGGGTTTCTACTGGTG
AOB_MK_Microcosms_Metsulfuron_methyl_028	TCAAGCTTAAGGGGTTTCTACTGGTG
AOB_MK_Microcosms_Metsulfuron_methyl_029	TCCGTTATAAGGGGTTTCTACTGGTG
AOB_MK_Microcosms_Metsulfuron_methyl_030	TCCGAGCTAAGGGGTTTCTACTGGTG
AOB_MK_Microcosms_Metsulfuron_methyl_031	TCCGCTGCAAGGGGTTTCTACTGGTG
AOB_MK_Microcosms_Metsulfuron_methyl_032	TCCGCCTTAAGGGGTTTCTACTGGTG
AOB_MK_Microcosms_Metsulfuron_methyl_033	TCGTTACTAAGGGGTTTCTACTGGTG
AOB_MK_Microcosms_Metsulfuron_methyl_034	TCGTTGTCAAGGGGTTTCTACTGGTG
AOB_MK_Microcosms_Metsulfuron_methyl_035	TCGTCTATAAGGGGTTTCTACTGGTG
AOB_MK_Microcosms_Metsulfuron_methyl_036	TCGTGTGCAAGGGGTTTCTACTGGTG
AOB_MK_Microcosms_Metsulfuron_methyl_037	TCGACATTAAGGGGTTTCTACTGGTG
AOB_MK_Microcosms_Metsulfuron_methyl_038	TCGACGGCAAGGGGTTTCTACTGGTG
AOB_MK_Microcosms_Metsulfuron_methyl_039	TCGCATACAAGGGGTTTCTACTGGTG
AOB_MK_Microcosms_Metsulfuron_methyl_040	TCGCCGCTAAGGGGTTTCTACTGGTG
AOB_MK_Microcosms_Metsulfuron_methyl_041	TCGCGATCAAGGGGTTTCTACTGGTG
AOB_MK_Microcosms_Metsulfuron_methyl_042	TGTTCTCTAAGGGGTTTCTACTGGTG
AOB_MK_Microcosms_Metsulfuron_methyl_043	TGTTGCTTAAGGGGTTTCTACTGGTG
AOB_MK_Microcosms_Metsulfuron_methyl_044	TGTCTACTAAGGGGTTTCTACTGGTG
AOB_MK_Microcosms_Metsulfuron_methyl_045	TGTGTCATAAGGGGTTTCTACTGGTG
AOB_MK_Microcosms_Metsulfuron_methyl_046	TGTGCGTTAAGGGGTTTCTACTGGTG
AOB_MK_Microcosms_Metsulfuron_methyl_047	TGATTCCTAAGGGGTTTCTACTGGTG
AOB_MK_Microcosms_Metsulfuron_methyl_048	TGACTGATAAGGGGTTTCTACTGGTG
AOB_MK_Microcosms_Metsulfuron_methyl_049	TGAGCTATAAGGGGTTTCTACTGGTG
AOB_MK_Microcosms_Metsulfuron_methyl_050	TGAGGACTAAGGGGTTTCTACTGGTG
AOB_MK_Microcosms_Metsulfuron_methyl_051	TGCTTGTTAAGGGGTTTCTACTGGTG
AOB_MK_Microcosms_Metsulfuron_methyl_052	TGCTACATAAGGGGTTTCTACTGGTG
AOB_MK_Microcosms_Metsulfuron_methyl_053	TGCATTCTAAGGGGTTTCTACTGGTG
AOB_MK_Microcosms_Metsulfuron_methyl_054	TGCCGATTAAGGGGTTTCTACTGGTG
AOB_MK_Microcosms_Metsulfuron_methyl_055	TGGTGGATAAGGGGTTTCTACTGGTG
AOB_MK_Microcosms_Metsulfuron_methyl_056	TGGATCTTAAGGGGTTTCTACTGGTG
AOB_MK_Microcosms_Metsulfuron_methyl_057	TGGCGTCTAAGGGGTTTCTACTGGTG
AOB_MK_Microcosms_Metsulfuron_methyl_058	ATTAAGGCAAGGGGTTTCTACTGGTG
AOB_MK_Microcosms_Metsulfuron_methyl_059	ATTCTCCTAAGGGGTTTCTACTGGTG
AOB_MK_Microcosms_Metsulfuron_methyl_060	ATTCTGACAAGGGGTTTCTACTGGTG
AOB_MK_Microcosms_Metsulfuron_methyl_061	ATTCCTTCAAGGGGTTTCTACTGGTG
AOB_MK_Microcosms_Metsulfuron_methyl_062	ATTCGCGCAAGGGGTTTCTACTGGTG
AOB_MK_Microcosms_Metsulfuron_methyl_063	ATTCGGTTAAGGGGTTTCTACTGGTG
AOB_MK_Microcosms_Metsulfuron_methyl_064	ATTGTTGCAAGGGGTTTCTACTGGTG
AOB_MK_Microcosms_Metsulfuron_methyl_065	ATTGAGCTAAGGGGTTTCTACTGGTG
AOB_MK_Microcosms_Metsulfuron_methyl_066	ATTGGATCAAGGGGTTTCTACTGGTG
AOB_MK_Microcosms_Metsulfuron_methyl_067	ATATCCTCAAGGGGTTTCTACTGGTG
AOB_MK_Microcosms_Metsulfuron_methyl_068	ATAATCGCAAGGGGTTTCTACTGGTG
AOB_MK_Microcosms_Metsulfuron_methyl_069	ATAAGCCTAAGGGGTTTCTACTGGTG
AOB_MK_Microcosms_Metsulfuron_methyl_070	ATAAGGTCAAGGGGTTTCTACTGGTG
AOB_MK_Microcosms_Metsulfuron_methyl_071	ATACATGCAAGGGGTTTCTACTGGTG
AOB_MK_Microcosms_Metsulfuron_methyl_072	ATCTTGTCAAGGGGTTTCTACTGGTG
AOB_MK_Microcosms_Metsulfuron_methyl_073	ATCTAAGCAAGGGGTTTCTACTGGTG
AOB_MK_Microcosms_Metsulfuron_methyl_074	ATCTCGCTAAGGGGTTTCTACTGGTG
AOB_MK_Microcosms_Metsulfuron_methyl_075	ATCCGTCTAAGGGGTTTCTACTGGTG
AOB_MK_Microcosms_Metsulfuron_methyl_076	ATCGATTCAAGGGGTTTCTACTGGTG
AOB_MK_Microcosms_Metsulfuron_methyl_077	ATCGCGACAAGGGGTTTCTACTGGTG
AOB_MK_Microcosms_Metsulfuron_methyl_078	ATCGGCTTAAGGGGTTTCTACTGGTG
AOB_MK_Microcosms_Metsulfuron_methyl_079	ATGTCTGCAAGGGGTTTCTACTGGTG
AOB_MK_Microcosms_Metsulfuron_methyl_080	ATGTGACTAAGGGGTTTCTACTGGTG
AOB_MK_Microcosms_Metsulfuron_methyl_081	ATGATGCTAAGGGGTTTCTACTGGTG
AOB_MK_Microcosms_Metsulfuron_methyl_082	ATGACATCAAGGGGTTTCTACTGGTG
AOB_MK_Microcosms_Metsulfuron_methyl_083	ATGGACGCAAGGGGTTTCTACTGGTG
AOB_MK_Microcosms_Metsulfuron_methyl_084	ATGGCTCTAAGGGGTTTCTACTGGTG
AOB_MK_Microcosms_Metsulfuron_methyl_085	AATTGTGCAAGGGGTTTCTACTGGTG
AOB_MK_Microcosms_Metsulfuron_methyl_086	AATTGCCTAAGGGGTTTCTACTGGTG
AOB_MK_Microcosms_Metsulfuron_methyl_087	AATACGACAAGGGGTTTCTACTGGTG
AOB_MK_Microcosms_Metsulfuron_methyl_088	AATCCGCTAAGGGGTTTCTACTGGTG
AOB_MK_Microcosms_Metsulfuron_methyl_089	AATGTGTCAAGGGGTTTCTACTGGTG
AOB_MK_Microcosms_Metsulfuron_methyl_090	AAGCTTACAAGGGGTTTCTACTGGTG
AOB_MK_Microcosms_Metsulfuron_methyl_091	AAGCAAGCAAGGGGTTTCTACTGGTG
AOB_MK_Microcosms_Metsulfuron_methyl_092	AAGCCGTCAAGGGGTTTCTACTGGTG